SO ./assets/Stone_tiled_bricks_01.xpm
EA ./assets/Stone_tiled_bricks_01.xpm
NO ./assets/Stone_tiled_bricks_01.xpm
WE ./assets/Stone_tiled_bricks_01.xpm

F 76,51,49
C 205,75,8,,,,,

      111 1111111111111111
     10011100000000011111111
111111C0011C11011110C0011111111
    10010000100000011100011111111
    10111111111111111111000001111
  1100000C000000000000001111000111
 11111111111111111100111000001001111
10000000000000000000000111011001111111
 100011111110001111111111101C0111111
  11C100000000000000001110011000C011111
  100111111C100000001111C011101010111
 10001000000011100000110011100101011111
10001100000001S10111001000010010010001
10001111111111010000000110010011C0011
1000000000000000000000011111111001111
11111111111111111111110000000100111
11111111    1111111 11111000011011
1111111       111    11111110000C1
11111           111111111111111111
1111       11111111111111111111
111         11111111111111111
11           111111   11  11