NO ./assets/north.xpm
SO ./assets/south.xpm
EA ./assets/east.xpm

F 220,100,0
C 255,30,0
WE ./assets/west.xpm

     11111111 11 1111111111111
     111111 111 11111111
    11111111111111111
  11000000000000000001
 1100000000000000000001111
10000000000000000000000111
 10000000000000000000001111
  11000000000000000000111
  100000000000000E0OOO 1
 1000000000000000000001
10000000000000000000001
1000000000000000000000011
10000000000000000000000111
11111111111111111111111
11111111    1111111 11
1111111       111    1
11111
