NO ./assets/north.xpm
SO ./assets/south.xpm
WE ./assets/west.xpm
EA ./assets/east.xpm

F 220,100,0
C 255,30,0

     11111111 11 1111111111111
     111111 111 11111111
    11111111111111111
  11000000000000000001
 111111111111111111001111
10000000000000000000000111
 1000111111100011111111111
  11010000000000000000111
  10010000000000000011
 100010000000111000001
10001100000001E10000001
1000111111111101000000011
10000000000000000000000111
11111111111111111111111
11111111    1111111 11
1111111       111    1
11111
