NO ./assets/north.xpm
SO ./assets/south.xpm
WE ./assets/west.xpm
EA ./assets/east.xpm

F 220,100,0
C 255,30,0

     11111111 11 1111111111111
     111111 111 11111111
    1111111111111111111111
  1100000000000000000000001
 110000000000000000000000001111
1000000000000000000000000000111
 1000000000000000000000000001111
  1100000000000000000000000111
  1000000000000000000000011
 10000000000000000000000001
10000000000000S0000000000001
100000000000000000000000000011
1000000000000000000000000000111
1111111111111111111111111111
11111111    1111111 11
1111111       111    1
11111
