NO ./assets/test_north.xpm
SO ./assets/test_south.xpm
WE ./assets/test_west.xpm
EA ./assets/test_east.xpm

C 255,30,0
F 220,100,0

111111111111
100000000001
1000     001
100000W00001
100000000001
111111111111
