NO ./assets/north.xpm
SO ./assets/south.xpm
WE ./assets/west.xpm
EA ./assets/east.xpm

F 220,100,0
C 255,30,0

  1111111111111111
  1100000000000001
 1000000000000000111
10000000000000000001
 100000000000000001
  1000000000000001
  100000000000001
 10000000000000001
10000000000000E0001
10000000000000000001
10000000000000000001
11111111111111111111
