NO ../assets/north.xpm
SO ../assets/south.xpm
WE ../assets/west.xpm
EA ../assets/east.xpm

F 220,100,0
C 255,30,0

  11111111111111
  100N0000000001
 10000000000001
10000000000001
10000000000001
10000000000001
11111111111111
