NO ../assets/north.xpm
SO ../assets/sonuth.xpm
WE ../assets/west.xpm
EA ../assets/east.xpm

F 220,100,0
C 220,100,0

101111111111111
100000001000001
110000000100001
10000000010N01
1011111111111
10000000000001
11111111111111
