WE west
NO north
SO south

C 255,30,0
F 220,100,0

  11111111111111
  10000000000001
 100000000000N1
10000000000001
10000000000001
10000000000001
11111111111111
