NO ../assets/north.xpm
SO ../assets/south.xpm
WE ../assets/west.xpm
EA ../assets/east.xpm

F 220,100,0
C 220,100,0

11111111111111
100000000000001
110000000100001
100000000010N01
10111111110001
10000000100001
 1111101111111
