NO ../assets/north.xpm
SO ../assets/south.xpm
WE ../assets/west.xpm
EA ../assets/east.xpm

F 220,100,0
C 220,100,0

11111111111111
100000000000001
1100  000100001
1000  01110100E1
101111100011111
100000001000000
 1111111111111
